==Metadata==
=Size=
nlines=50
ncol=100
=Types=
G=1
green
W=1000
gray
B=20
blue
S=30
yellow
==Graph==
GGGGGGGGGGGGGGGGGGGGGGGGGGGGGGGGGGGGGGGGGGGGGGGGGGGGGGGGGGGGGGGGGGGGGGGGGGGGGGGGGGGGGGGGGGGGGGGGGGGG
GGGGGGGGGGGGGGGGGGGGGGGGGGGGGGGGGGGGGGGGGGGGGGGGGGGGGGGGGGGGGGGGGGGGGGGGGGGGGGGGGGGGGGGGGGGGGGGGGGGG
GGWWWWWWWWWWWWWWWWWWWWWWWWWWWWWWWWWWWWWWWWWWWWWWWWWWWWWWWWWWWWWWWWWWWWWWWWWWWWWWWWWWWWWWWWWWWWWWWWGG
GGWGGGGGGGGGGGGGGGGGGGGGGGGGGGGGGGGGGGGGGGGGGGGGGGGGGGGGGGGGGGGGGGGGGGGGGGGGGGGGGGGGGGGGGGGGGGGGGWGG
GGWGGWWWWWWWWWWWWWWWWWWWWWWWWWWWWWWWWWWWWWWWWWWWWWWWWWWWWWWWWWWWWWWWWWWWWWWWWWWWWWWWWWWWWWWWWWWGGWGG
GGWGGWGGGGGGGGGGGGGGGGGGGGGGGGGGGGGGGGGGGGGGGGGGGGGGGGGGGGGGGGGGGGGGGGGGGGGGGGGGGGGGGGGGGGGGGGWGGWGG
GGWGGWGGWWWWWWWWWWWWWWWWWWWWWWWWWWWWWWWWWWWWWWWWWWWWWWWWWWWWWWWWWWWWWWWWWWWWWWWWWWWWWWWWWWWWGGWGGWGG
GGWGGWGGWGGGGGGGGGGGGGGGGGGGGGGGGGGGGGGGGGGGGGGGGGGGGGGGGGGGGGGGGGGGGGGGGGGGGGGGGGGGGGGGGGGWGGWGGWGG
GGWGGWGGWGGWWWWWWWWWWWWWWWWWWWWWWWWWWWWWWWWWWWWWWWWWWWWWWWWWWWWWWWWWWWWWWWWWWWWWWWWWWWWWWGGWGGWGGWGG
GGWGGWGGWGGWGGGGGGGGGGGGGGGGGGGGGGGGGGGGGGGGGGGGGGGGGGGGGGGGGGGGGGGGGGGGGGGGGGGGGGGGGGGGWGGWGGWGGWGG
GGWGGWGGWGGWGGWWWWWWWWWWWWWWWWWWWWWWWWWWWWWWWWWWWWWWWWWWWWWWWWWWWWWWWWWWWWWWWWWWWWWWWWGGWGGWGGWGGWGG
GGWGGWGGWGGWGGWGGGGGGGGGGGGGGGGGGGGGGGGGGGGGGGGGGGGGGGGGGGGGGGGGGGGGGGGGGGGGGGGGGGGGGWGGWGGWGGWGGWGG
GGWGGWGGWGGWGGWGGWWWWWWWWWWWWWWWWWWWWWWWWWWWWWWWWWWWWWWWWWWWWWWWWWWWWWWWWWWWWWWWWWWGGWGGWGGWGGWGGWGG
GGWGGWGGWGGWGGWGGWGGGGGGGGGGGGGGGGGGGGGGGGGGGGGGGGGGGGGGGGGGGGGGGGGGGGGGGGGGGGGGGGWGGWGGWGGWGGWGGWGG
GGWGGWGGWGGWGGWGGWGGWWWWWWWWWWWWWWWWWWWWWWWWWWWWWWWWWWWWWWWWWWWWWWWWWWWWWWWWWWWWGGWGGWGGWGGWGGWGGWGG
GGWGGWGGWGGWGGWGGWGGWGGGGGGGGGGGGGGGGGGGGGGGGGGGGGGGGGGGGGGGGGGGGGGGGGGGGGGGGGGWGGWGGWGGWGGWGGWGGWGG
GGWGGWGGWGGWGGWGGWGGWGGWWWWWWWWWWWWWWWWWWWWWWWWWWWWWWWWWWWWWWWWWWWWWWWWWWWWWWGGWGGWGGWGGWGGWGGWGGWGG
GGWGGWGGWGGWGGWGGWGGWGGWGGGGGGGGGGGGGGGGGGGGGGGGGGGGGGGGGGGGGGGGGGGGGGGGGGGGWGGWGGWGGWGGWGGWGGWGGWGG
GGWGGWGGWGGWGGWGGWGGWGGWGGWWWWWWWWWWWWWWWWWWWWWWWWWWWWWWWWWWWWWWWWWWWWWWWWGGWGGWGGWGGWGGWGGWGGWGGWGG
GGWGGWGGWGGWGGWGGWGGWGGWGGWGGGGGGGGGGGGGGGGGGGGGGGGGGGGGGGGGGGGGGGGGGGGGGWGGWGGWGGWGGWGGWGGWGGWGGWGG
GGWGGWGGWGGWGGWGGWGGWGGWGGWGGWWWWWWWWWWWWWWWWWWWWWWWWWWWWWWWWWWWWWWWWWWGGWGGWGGWGGWGGWGGWGGWGGWGGWGG
GGWGGWGGWGGWGGWGGWGGWGGWGGWGGWGGGGGGGGGGGGGGGGGGGGGGGGGGGGGGGGGGGGGGGGWGGWGGWGGWGGWGGWGGWGGWGGWGGWGG
GGWGGWGGWGGWGGWGGWGGWGGWGGWGGWGGWWWWWWWWWWWWWWWWWWWWWWWWWWWWWWWWWWWWGGWGGWGGWGGWGGWGGWGGWGGWGGWGGWGG
GGWGGWGGWGGWGGWGGWGGWGGWGGWGGWGGWGGGGGGGGGGGGGGGGGGGGGGGGGGGGGGGGGGWGGWGGWGGWGGWGGWGGWGGWGGWGGWGGWGG
GGWGGWGGWGGWGGWGGWGGWGGWGGWGGWGGWGGWWWWWWWWWWWWWWWWWWWWWWWWWWWWWWGGWGGWGGWGGWGGWGGWGGWGGWGGWGGWGGWGG
GGWGGWGGWGGWGGWGGWGGWGGWGGWGGWGGWGGWGGGGGGGGGGGGGGGGGGGGGGGGGGGGWGGWGGWGGWGGWGGWGGWGGWGGWGGWGGWGGWGG
GGWGGWGGWGGWGGWGGWGGWGGWGGWGGWGGWGGWGGWWWWWWWWWWWWWWWWWWWWWWWWGGWGGWGGWGGWGGWGGWGGWGGWGGWGGWGGWGGWGG
GGWGGWGGWGGWGGWGGWGGWGGWGGWGGWGGWGGWGGWGGGGGGGGGGGGGGGGGGGGGGWGGWGGWGGWGGWGGWGGWGGWGGWGGWGGWGGWGGWGG
GGWGGWGGWGGWGGWGGWGGWGGWGGWGGWGGWGGWGGWGGWWWWWWWWWWWWWWWWWWGGWGGWGGWGGWGGWGGWGGWGGWGGWGGWGGWGGWGGWGG
GGWGGWGGWGGWGGWGGWGGWGGWGGWGGWGGWGGWGGWGGWGGGGGGGGGGGGGGGGWGGWGGWGGWGGWGGWGGWGGWGGWGGWGGWGGWGGWGGWGG
GGWGGWGGWGGWGGWGGWGGWGGWGGWGGWGGWGGWGGWGGWGGWWWWWWWWWWWWGGWGGWGGWGGWGGWGGWGGWGGWGGWGGWGGWGGWGGWGGWGG
GGWGGWGGWGGWGGWGGWGGWGGWGGWGGWGGWGGWGGWGGWGGWGGGGGGGGGGWGGWGGWGGWGGWGGWGGWGGWGGWGGWGGWGGWGGWGGWGGWGG
GGWGGWGGWGGWGGWGGWGGWGGWGGWGGWGGWGGWGGWGGWGGWGGWWWWWWGGWGGWGGWGGWGGWGGWGGWGGWGGWGGWGGWGGWGGWGGWGGWGG
GGWGGWGGWGGWGGWGGWGGWGGWGGWGGWGGWGGWGGWGGWGGWGGWGGGGWGGWGGWGGWGGWGGWGGWGGWGGWGGWGGWGGWGGWGGWGGWGGWGG
GGWGGWGGWGGWGGWGGWGGWGGWGGWGGWGGWGGWGGWGGWGGWGGWGGGGWGGWGGWGGWGGWGGWGGWGGWGGWGGWGGWGGWGGWGGWGGWGGWGG
GGWGGWGGWGGWGGWGGWGGWGGWGGWGGWGGWGGWGGWGGWGGWGGWGGGGWGGWGGWGGWGGWGGWGGWGGWGGWGGWGGWGGWGGWGGWGGWGGWGG
GGWGGWGGWGGWGGWGGWGGWGGWGGWGGWGGWGGWGGWGGWGGWGGWGGGGWGGWGGWGGWGGWGGWGGWGGWGGWGGWGGWGGWGGWGGWGGWGGWGG
GGWGGWGGWGGWGGWGGWGGWGGWGGWGGWGGWGGWGGWGGWGGWGGWGGGGWGGWGGWGGWGGWGGWGGWGGWGGWGGWGGWGGWGGWGGWGGWGGWGG
GGWGGWGGWGGWGGWGGWGGWGGWGGWGGWGGWGGWGGWGGWGGWGGWGGGGWGGWGGWGGWGGWGGWGGWGGWGGWGGWGGWGGWGGWGGWGGWGGWGG
GGWGGWGGWGGWGGWGGWGGWGGWGGWGGWGGWGGWGGWGGWGGWGGWGGGGWGGWGGWGGWGGWGGWGGWGGWGGWGGWGGWGGWGGWGGWGGWGGWGG
GGWGGWGGWGGWGGWGGWGGWGGWGGWGGWGGWGGWGGWGGWGGWGGWGGGGWGGWGGWGGWGGWGGWGGWGGWGGWGGWGGWGGWGGWGGWGGWGGWGG
GGWGGWGGWGGWGGWGGWGGWGGWGGWGGWGGWGGWGGWGGWGGWGGWGGGGWGGWGGWGGWGGWGGWGGWGGWGGWGGWGGWGGWGGWGGWGGWGGWGG
GGWGGWGGWGGWGGWGGWGGWGGWGGWGGWGGWGGWGGWGGWGGWGGWGGGGWGGWGGWGGWGGWGGWGGWGGWGGWGGWGGWGGWGGWGGWGGWGGWGG
GGWGGWGGWGGWGGWGGWGGWGGWGGWGGWGGWGGWGGWGGWGGWGGWGGGGWGGWGGWGGWGGWGGWGGWGGWGGWGGWGGWGGWGGWGGWGGWGGWGG
GGWGGWGGWGGWGGWGGWGGWGGWGGWGGWGGWGGWGGWGGWGGWGGWGGGGWGGWGGWGGWGGWGGWGGWGGWGGWGGWGGWGGWGGWGGWGGWGGWGG
GGWGGWGGWGGWGGWGGWGGWGGWGGWGGWGGWGGWGGWGGWGGWGGWGGGGWGGWGGWGGWGGWGGWGGWGGWGGWGGWGGWGGWGGWGGWGGWGGWGG
GGWGGWGGWGGWGGWGGWGGWGGWGGWGGWGGWGGWGGWGGWGGWGGWGGGGWGGWGGWGGWGGWGGWGGWGGWGGWGGWGGWGGWGGWGGWGGWGGWGG
GGWGGWGGWGGWGGWGGWGGWGGWGGWGGWGGWGGWGGWGGWGGWGGWGGGGGGGGGGGGGGGGGGGGGGGGGGGGGGGGGGGGGGGGGGGGGGGGGGWGG
GGWWWWWWWWWWWWWWWWWWWWWWWWWWWWWWWWWWWWWWWWWWWWWWWWWWWWWWWWWWWWWWWWWWWWWWWWWWWWWWWWWWWWWWWWWWWWWWWWGG
GGGGGGGGGGGGGGGGGGGGGGGGGGGGGGGGGGGGGGGGGGGGGGGGGGGGGGGGGGGGGGGGGGGGGGGGGGGGGGGGGGGGGGGGGGGGGGGGGGGG
==Path==
Start=0,0
Finish=35,50